!!!!!!!!!!
!.&.#.*.#!
!........!
!##...*..!
!........!
!......##!
!*.#.....!
!..#.....!
!..#.@...!
!!!!!!!!!!