!!!!!!!!!!
!.&.#...#!
!........!
!.....*..!
!........!
!##..###.!
!.#....&.!
!##......!
!#...@...!
!!!!!!!!!!