!!!!!!!!!!
!/..*...&!
!......#.!
!..#..#..!
!..#.....!
!.#..##..!
!.#...#..!
!.....#..!
!....@...!
!!!!!!!!!!