!!!!!!!!!!
!/..*...&!
!........!
!..#..#..!
!.&#.....!
!..#..#..!
!..#.....!
!.....#..!
!....@...!
!!!!!!!!!!