!!!!!!!!!!
!./..../.!
!.*.**.*.!
!..####..!
!........!
!###..###!
!#......#!
!#......#!
!#...@..#!
!!!!!!!!!!