!!!!!!!!!!
!./..../.!
!.&....&.!
!..###...!
!#......#!
!......##!
!..#.....!
!..#.....!
!/.#.@...!
!!!!!!!!!!