!!!!!!!!!!
!...&....!
!........!
!/.#..#./!
!###..###!
!........!
!........!
!..#..#..!
!/.#.@#./!
!!!!!!!!!!