!!!!!!!!!!
!..#.#.##!
!##..###.!
!#.......!
!....@.#.!
!##..###.!
!.#..#...!
!##.##.#.!
!#......#!
!!!!!!!!!!