!!!!!!!!!!
!...#..##!
!##..###.!
!#.......!
!......#.!
!##..###.!
!.#......!
!##....#.!
!#...@..#!
!!!!!!!!!!