!!!!!!!!!!
!...#...#!
!./......!
!.....*..!
!........!
!##..###.!
!.#....&.!
!##......!
!#...@...!
!!!!!!!!!!