######
...#.#.####
.##..###..#
##........#
#....@.#..#
###..###..#
..#..#....#
.##.##.#.##
.#......##
.#.....##
.#######